######################################################
#       ##############################################
#            ###               ######    ##          #
#       #### ###    ########## ####      ## ######## #
#       #### ###### ########## #### #    ## ######## #
#       #### ###### ###          ## #    ## ##   ### #
#       ####    ### ###  #    #  ## ## #### ## # ### #
## ######### ## ### ###  #    #  ## #    ##    # ### #
#     ###### ## ### ###  #    #  ## #    ####### ### #
#     ###### ## ### ###  #    #  ## #    ##       ## #
############ ## ### ###          ## ### ###       ## #
############ ##     ######### ##### #    ##       ## #
#   #        ################ ##### #             ## #
#     #############        ##       ################ #
#   # #############  ####  ######################### #
##### #########      #  #       ######          #### #
#   # ######### ###        #### #####            ### #
#     ######### ############### ####    #         ## #
#   #           ######          ###                # #
###### ### ### ####################       ##         #
#   #   #   #   ##      ##    #####                ###
#       #   #   ## #### ##    ######         #    ####
#   #   #   #      #### ##    #######            #####
#######################       ########          ######
######################################################